10.ox
....o.oooo
.o........
.....o.oo.
..o......o
.....oo...
o.....o...
......o..o
o...o.o...
.o..o.....
......ooo.
